-*                                            =%%%#############################
#%                                           .%%%##############################
%%-                                          =%%%##############################
%%+                                          *%%###############################
%%-                                          *%%###############################
%%%                                          +%%%%#####%%%%####################
%%%                                           =%%%%%%%%%%%%**%%################
%%%                                            **%%%%%%%%*****%%###############
%%%                   :     @                   .:+====-. .:=*%%###############
%%%                  @@    @@                                -%%###############
%%%.                 @@  @@:@                                 *%%##############
%%%                 @+@ @:  @                                 =%%##############
#%%=                @.@.@   @                                 =%%##############
#%%*              @@+ @.@   @                                 :%%##############
#%%*             .@:: @.@   @                                 .%%%#############
##%*+            @+ : @.@   .@                                 %%%#############
##%%*           @+  : @.@    @                                 =**%%%%#########
##%%*          @@:  : @.@    -@                                 -**%%%%########
###%*:         @+   - @.@    .@                                  .-*%%%########
###%**        @@.   - @.@     @@                                    *%%########
###%*%:       @-    - @.@     :@                                    =%%########
###%%*.      @:.    : @.@      @                                    +%%########
####%*.      @-     ..@.@      :@                                   :%%########
####%%-      @@      -@.@       -@@@                                 *%%#######
####%%=       @@@@@@ @@.@      @@@@@@                                =%%#######
####%%%             @@@.@@@@@@@@        @@@@    @@@@@@@              -%%%######
####%%%             @ -...       .    @@@@@@    @@@@@@@    @@@@       %%%######
####%%%            @@========++++=@   @@@@@@    @@@@@@@    @@@@@      *%%######
####%%%            @+++++++++++++@@   @@@@@                @@@@@@     .%%%#####
#####%%=           @@===========@@    @@@                   @@@@@      *%%#####
#####%%%            @@@@@@@@@@@@@                             @@@      *%%#####
#####%%%=                                                         @@@  -*%%####
######%%*                                                         @@@@  **%####
######%%*:                                                        @@@@  :**####
#######%*:                                                        @@@@   ==*###
#######%*+                                                *%%%%=   @@@   =*=%#+
#######%*+                                            .#%%%%%%%%%         *%*%*
#######%*.                                          =%%%%%%%%%%%%%        =*=%%
######%%*                                         =%%%%%%%%%%%%%%%*        **%%
######%%*                                       =*%%%%%%%%#######%%*   @@@ +*%%
######%**                                      *%%%%%%%%#########%%%+  @@@@ =%%
######%**                                     %%%%################%%%. @@@@@ *%
#####%**-                                   *%%%%##################%%=  @@@@ =%
####%%*-                                   *%%%%###################%%%  @@@@  :
###%%*:                                    %%%%####################%%%:  @@@   
##%%**                                    *%%%#####################%%%*        
##%%*.                                   =%%%#######################%%%        
##%%+                                    *%%########################%%%        
#%%%                                    =%%%########################%%%        
#%%%                                   *%%%#########################%%*  @@@   
#%%%                                   %%%########################%%%%=  @@@   
#%%%                                   %%%######################%%%%%*   @@@   
%%%%                                  .%%%#########%%%%%%%%##%%%%%%%%:   @@@   
%%%#                                   %%%########%%%%%%%%%%%%%%%%%%=    @@@   
%%%%                      .--          =%%%######%%%%*==*%*%%%%%**       @@@   
%%%%                    .-=.--.:        *%%#####%*%*=    :   .-          @@@   
%%%%                  .+===-==%++       .*%%###%*%%+                           
#%%%%                :*-::-:::-=-        .*%%#%*%*+                            
##%%%.               =-::::-:::+-         -*%**%*+                      @@@    
##%%%%              -+:::=*%:::-%.     .:::-=*%*+                       @@@    
###%%%:             +-:::=++:::-%-    :=*+**=.*-                        @@@    
###%%%%             ---::--::::-*.   -==-::::=%:      .-             @@@       
####%%%%            .=+-**--+::+:   ++::::::::*.    .=*%=-           @@@       
####%%%%             .-=**++*::*.  :*=::::::::-+   .*+.::=-          @@@       
#####%%%%               .=:++::=-  =*-:::=*-:::*-  +%-.:::+:         @@@       
######%%%:              -+-=::-=: .+:::-==-=-::*-  -::-=*=+:         @@@       
#######%%=              *::+::+:  -*:::=*-=-+::=  :*::**::.          @@@       
#######%%=             .+:--::+.  ==-::=+ +-=::*: -@::*-                       
#######%=*             -=-=-::%-  **::-=- =:+::*- ++.:*.                     -=
#######%**             --:+:::%+  =-::-*: *:=:-+  ---+=                    -*%%
#######%**             +-:+::++   =+++*=  -===-    .::             @@@    +*%%%
#######**=             .++=++:     .::.                            @@@   :*%%%%
######%*=                                                         @@@@   *%%%%%
#####%%*:                      ..                                 @@@@  =%%%%%%
#####%%*                    :=*********=-.                        @@@@  *%%%%%%
####%%%-                .+=*%%%%%%%%%%*****=-                          -*%%%%%%
####%%*            *%%%%%%%%%%%%%#%%%%%%%**%*=.                        =%%%%%%%
####%%=           *%%%%%%%%%%############%%****=                       *%%%%%%%
###%%%:          *%%%%%%%###################%%%%*               @@@   .*%%%%%%%
###%%*.         *%%%%#########################%%%=.            @@@@   -*%%%%%%%
###%%=          %%%%###########################%%%*-           @@@@   +%%%%%%%%
##%%*           %%%#############################%%%*:          @@@@   =%%%%%%%%
##%%=          :%%###############################%%%*.         @@@    =%%%%%%%%
+%%=           =%%%###############################%%**                *%%%%%%%%
*%%=           +%%%################################%%*=               *%%%%%%%%
%%%*            %%%%################################%%%*      @@@@    %%%%%%%%%
%%%*            *%%%%################################%%%*     @@@@    %%%%%%%%%
%%*              %%%%################################%%*%=    @@@@    %%%%%%%%%
%*:               %%%%%%%%%%%%%%%######################%%%*    @@@    %%%%%%%%%
*                  *%%%%%%%%%%%%%%%%%%##################%%*=   @@@    *%%%%%%%%
=                   *%%%%%%%%%%%%%%%%%%%%%###############%%*   @@@    *%%%%%%%%
                      *%***%%*****%%%%%%%%%%%############%%*.  @@@    =%%%%%%%%
                                  ..  +=*%%%%%%%%%%%%%%%##%*-         =%%%%%%%%
                                         .+=*%%%%%%%%%%%%%%%+         =%%%%%%%%
                                             .-=**%%%%%%%%%*         @@@@%%%%%%
                                                     *%%@@@*        @@@@@%%%%%%
                                                        @@@@       @@@@@@%%%%%%
                                                        @@@@@     @@@@@@%%%%%%%
                                                        @@@@@@   @@@@@@%%%%%%%%
                                                         @@@@@@ @@@@@@-%%%%%%%%
                                                          @@@@@@@@@@  -%%%%%%%%
                                                            @@@@@@@   +%%%%%%%%
                                                            @@@@@@@   +%%%%%%%%
                                                           @@@@@@@@@  -%%%%%%%%
                                                          @@@@@@@@@@@ .*%%%%%%%
                                                         @@@@@@ @@@@@@ =%%%%%%%
                                                        @@@@@@   @@@@@@:*%%%%%%
                                                       @@@@@@     @@@@@@=%%%%%%
                                                       @@@@@       @@@@@.*%%%%%
                                                       @@@@         @@@@ -*#%%%
